G G G G G G G G G G G G G G G G G G G G
G G G G G G G G G G G G G G G G G G G G
G G G S W W G G S W W W W W W W D G G G
G G G S G N G G S G G G G G G G G G G G
G G G S G N G G E E E E E E E E S G G G
G G G S G N G G G G G G G G G G S G G G
G G G S G N W W W W W W W W W W W G G G
G G G S G G G G G G G G G G G G G G G G
G G G S G G G G G G G G G G G G G G G G
G G G S G G G G G G G G G G G G G G G G
G G G E E E E E E E E E E E E E E S G G
G G G G G G G G G G G G G G G G G S G G
G G G G G G G G G G G G G G G G G S G G
G G G G G G G G S W W W W G G G G S G G
G G G G G G G G S G G G N G G G G S G G
G G G G G G G G S G G G N G G G G S G G
G G G G G G G G S G G G N G G G G S G G
G G G G G H W W W G G G N W W W W W G G
G G G G G G G G G G G G G G G G G G G G
G G G G G G G G G G G G G G G G G G G G

