G G G G G G G G G G G G G G G G G G G G
G G G G G G G G G G G G G G G G G G G G
G G G G G G G G G G G G G G G G G G G G
G G B G G G G G G G G G G G G G G G G G
G G S G G G G G G G G G G G G G G G G G
G G S G E E S G E E E E E E E E E S G G
G G S G N G S G N G G G G G G G G S G G
G G S G N G S G N G G G G G G G G S G G
G G S G N G S G N G G G G G G G G S G G
G G S G N G S G N G G E E E E S G S G G
G G S G N G S G N G G N G G G S G S G G
G G S G N G S G N G G N G G G S G S G G
G G S G N G S G N G G N G H G S G S G G
G G S G N G S G N G G N G N W W G S G G
G G S G N G S G N G G N G G G G G S G G
G G S G N G S G N G G N G G G G G S G G
G G E E N G E E N G G N W W W W W W G G
G G G G G G G G G G G G G G G G G G G G
G G G G G G G G G G G G G G G G G G G G
G G G G G G G G G G G G G G G G G G G G


G - grass
N - road to north
S - road to south
E - road to east
W - road to west
T - tower
H - home base
A - enemy base to north
B - enemy base to south
C - enemy base to east
D - enemy base to west
