G G G G G G G G G G G G G G G G G G G G 
G G G G G G G G G C E E E E E E S G G G 
G G G G G G G G G G G G G G G G S G G G 
G G G G G G G G G G G G G G G G S G G G 
G G G G G G G G G G G G G G G G S G G G 
G G S W W W W W W W W W W W W W W G G G 
G G S G G G G G G G G G G G G G G G G G 
G G S G G G G G G G G G G G G G G G G G 
G G S G G G G G G G G G G G G G G G G G 
G G S G G G G G G E E E E S G G G G G G 
G G S G G G G G G N G G G S G G G G G G 
G G S G G G G G G N G G G S G G G H G G 
G G S G G G G G G N G G G S G G G N G G 
G G S G G G G G G N G G G S G G G N G G 
G G E E E E E E E N G G G E E E E N G G 
G G G G G G G G G G G G G G G G G G G G 
G G G G G G G G G G G G G G G G G G G G 
G G G G G G G G G G G G G G G G G G G G 
G G G G G G G G G G G G G G G G G G G G 
G G G G G G G G G G G G G G G G G G G G 
