G G G G G G G G G G G G G G G G G G G G 
G G G G G G G G G G G G G G G G G G G G 
G G G B G G G G G G G G G G G G G G G G 
G G G S G G G S W W W W W W W W W G G G 
G G G S G G G S G G G G G G G G N G G G 
G G G S G G G S G G G G G G G G N G G G 
G G G S G G G E E E E E E S G G N G G G 
G G G S G G G G G G G G G S G G N G G G 
G G G S G G G G G G G G G S G G N G G G 
G G G S G G S W W W W W W W G G N G G G 
G G G S G G S G G G G G G G G G N G G G 
G G G S G G S G G G G G G G G G N G G G 
G G G S G G E E E E E E H G G G N G G G 
G G G S G G G G G G G G G G G G N G G G 
G G G E E E E E E E E E E E E E N G G G 
G G G G G G G G G G G G G G G G G G G G 
G G G G G G G G G G G G G G G G G G G G 
G G G G G G G G G G G G G G G G G G G G 
G G G G G G G G G G G G G G G G G G G G 
G G G G G G G G G G G G G G G G G G G G 
